8 10
L L T T T C C T T T
L L T T T C C C C C
L L T T T C C T T T
L L T T T C C T T T
T L T T T C C T T T
T T T T T C C T T T
C C T T T C C T T T
C C T T T C C T T T
